{
  "id": "village",
  "name": "和平村",
  "width": 20,
  "height": 15,
  "tiles": [
    [1,1,1,1,1,1,1,1,1,1,1,1,1,1,1,1,1,1,1,1],
    [1,1,1,1,1,1,1,1,1,1,1,1,1,1,1,1,1,1,1,1],
    [1,1,2,2,2,2,1,1,1,1,1,1,2,2,2,2,1,1,1,1],
    [1,1,2,2,2,2,1,1,1,1,1,1,2,2,2,2,1,1,1,1],
    [1,1,1,1,1,1,1,1,1,1,1,1,1,1,1,1,1,1,1,1],
    [1,1,1,1,1,1,1,1,1,1,1,1,1,1,1,1,1,1,1,1],
    [1,1,1,1,1,1,1,1,1,1,1,1,1,1,1,1,1,1,1,1],
    [1,1,1,1,1,1,1,1,1,1,1,1,1,1,1,1,1,1,1,1],
    [1,1,1,1,1,1,1,1,1,1,1,1,1,1,1,1,1,1,1,1],
    [1,1,1,1,1,1,1,1,1,1,1,1,1,1,1,1,1,1,1,1],
    [3,3,3,3,3,3,3,3,3,1,1,3,3,3,3,3,3,3,3,3],
    [3,3,3,3,3,3,3,3,3,1,1,3,3,3,3,3,3,3,3,3],
    [3,3,3,3,3,3,3,3,3,1,1,3,3,3,3,3,3,3,3,3],
    [1,1,1,1,1,1,1,1,1,1,1,1,1,1,1,1,1,1,1,1],
    [1,1,1,1,1,1,1,1,1,1,1,1,1,1,1,1,1,1,1,1]
  ],
  "collision": [
    [0,0,0,0,0,0,0,0,0,0,0,0,0,0,0,0,0,0,0,0],
    [0,0,0,0,0,0,0,0,0,0,0,0,0,0,0,0,0,0,0,0],
    [0,0,1,1,1,1,0,0,0,0,0,0,1,1,1,1,0,0,0,0],
    [0,0,1,1,1,1,0,0,0,0,0,0,1,1,1,1,0,0,0,0],
    [0,0,0,0,0,0,0,0,0,0,0,0,0,0,0,0,0,0,0,0],
    [0,0,0,0,0,0,0,0,0,0,0,0,0,0,0,0,0,0,0,0],
    [0,0,0,0,0,0,0,0,0,0,0,0,0,0,0,0,0,0,0,0],
    [0,0,0,0,0,0,0,0,0,0,0,0,0,0,0,0,0,0,0,0],
    [0,0,0,0,0,0,0,0,0,0,0,0,0,0,0,0,0,0,0,0],
    [0,0,0,0,0,0,0,0,0,0,0,0,0,0,0,0,0,0,0,0],
    [1,1,1,1,1,1,1,1,1,0,0,1,1,1,1,1,1,1,1,1],
    [1,1,1,1,1,1,1,1,1,0,0,1,1,1,1,1,1,1,1,1],
    [1,1,1,1,1,1,1,1,1,0,0,1,1,1,1,1,1,1,1,1],
    [0,0,0,0,0,0,0,0,0,0,0,0,0,0,0,0,0,0,0,0],
    [0,0,0,0,0,0,0,0,0,0,0,0,0,0,0,0,0,0,0,0]
  ],
  "npcs": [
    {
      "id": "elder",
      "name": "村长",
      "x": 80,
      "y": 64,
      "dialogue_id": "village_elder"
    }
  ],
  "spawn_point": {
    "x": 160,
    "y": 200
  }
}
